####################
#@·················#
#··················#
#··················#
#··················#
#······#···###·····#
#······#·····#·····#
#······###C###·····#
#········#·#·······#
#········#·###·····#
#··················#
#··················#
#··················#
#·················X#
####################
