97575777399B3371D157
A@·················3
B··················B
E··················7
E··················E
8······F···FFF·····B
E······F·····F·····2
8······FFF·FFF·····B
8········F·F·······7
E········F·FFF·····2
9··················E
D··················2
8··················2
C·················X6
EC7DEE5ED7DD75D54E57
