95D79335557937375957
8@·················B
D··················3
9··················3
8··················A
E······F···FFF·····B
A······F·····F·····3
8······FFF·FFF·····7
C········F·F·······2
A········F·FFF·····7
D··················E
C··················6
8··················E
8·················XA
DCD5747C6574CEC57EEE
